# backrooms.map - the hand-tuned 32x32 Backrooms map, extracted from the
# fixed_map[] C literal (dogfood: proves the codegen round-trips a known-good
# level). Mirrors raycast_load_fixed()'s explicit setup; the 8 procedural
# place_partitions_fixed() dividers are omitted (only the 2 authored ones).
name: BACKROOMS
size: 32x32
spawn: 16.5, 28.5 facing=N

[grid]
################################
#...#...#...#..................#
#.......#...#.....############.#
#...#...#.........#..........#.#
##.###.####.###...#..######..#.#
#...#...#...#........#....#..#.#
#...#.......#.....#..###.##..#.#
#.......#.........#####.######.#
#...#...#...#..................#
##.###########.#.######.####.###
#.............#..#.............#
#.............#..#.............#
#.......##.......#....##.......#
#.......##....#.......##.......#
#.............#..#.............#
#..............................#
##.#####.######..#####.#####.###
#..............#.#......#......#
#.#####..#####.#.#.#....#.#....#
#.....#....#...#.#....#.#......#
#...########.....##.........#..#
#.....#....#...#.#.....#.......#
#.###..#######.#.#.#...........#
#...#........#.#...........#...#
#...######...#.#.#......#......#
#...#....#...#.#.#..#..........#
#.#####..#####...#..........#..#
#...#....#.....#.#.###...#.....#
#...####.#.###.#.#...#.........#
#............................#.#
#..............................#
################################

[crawl]
1,22 dir=S len=5

[partitions]
22,22 -> 26,22  style=spotted height=low
20,11 -> 20,14  style=spotted height=low

[decals]
outlet 17.0,26.5 face=W z=0.20
door   16.5,31.0 face=S

[options]
place_outlets: 12
place_exit_door: 0
lobby_ceiling: 0
